11110000000000001111
11110000000000001111
11110000000000001111
11110000000000001111
00000011111111000000
00000011114111000000
00000011113111000000
00000014235111000000
00000011132341000000
00000011121111000000
00000011141111000000
00000011111111000000
00000000000000000000
00000000000000000000
00000000000000000000
00000000000000000000
11110000000000001111
11110000000000001111
11110000000000001111
11110000000000001111