00000000000000000000
00000000000000000000
00000000000000000000
00000000000000000000
00000000000000000000
00000000000000000000
00000000111111000000
00000000122221000000
00000011133321000000
11111115234421000000
11111112344411111111
00000011112210111111
00000000011110000000
00000000110000000000
00000000110000000000
00000000110000000000
00000000110000000000
00000000000000000000
00000000000000000000
00000000000000000000