00000100000010000000
00000100000010000000
00000100000010000000
00000100000010000000
00000100000010000000
00000100000010000000
00000100000010000000
00001111001111100000
00011221001222100000
11112321111322111111
11112234444232111111
00011222212521100000
00001111111111000000
00000000000000000000
00000000000000000000
00001100000001100000
00001100000001100000
00000000000000000000
00000000000000000000
00000000000000000000