00000000000000000000
00000000000000000000
00000000000000000000
00000000000000000000
00000000000000000000
00001111111111100000
00000011111111000000
00000012212221000000
00000012344321000000
11110015349211001111
00000012344321000000
00000012212221000000
00000011111111000000
00000000000000000000
00000000000000000000
00001100000000110000
00000000000000000000
00000000111000000000
00000000000000000000
00000000000000000000