00000100000001000000
00000100000001000000
00000100000001000000
00000100000001000000
00000100000001000000
00000111111111000000
00000112544411000000
00000112222211000000
00000111322221000000
00000122222221000000
00000123213121000000
00000122212221000000
00011111111111111000
00001000000000010000
00000100000000100000
00000010000001000000
00000001000010000000
00000000111100000000
00000000111100000000
00000000111100000000