00000100000000000000
00000100000000000000
00000100000000000000
00000100000000000000
00000100000000000000
00000111111111111111
00000122510000000000
00000123310111000000
00000123210141000000
11111111211141000000
00000011222241000000
00000012221221000000
00000012221111000000
00000011111001000000
00000000000001000000
00000000000001000000
00000000000001000000
00000000000001000000
00000000000001000000
00000000000001000000