00010000000000000000
00001000000000000000
00000000000000000000
00000000000000000000
00000000000000000000
00001111111111000000
00001122222111000000
00001131112221000000
00001522322321000000
00001244123211000000
00001144122211000000
00001111111111000000
00001000000000000000
00001000000000000000
00111111001111110000
00001001001000010000
00010101001000010000
00100011001000010000
00100001001111110000
00000000000000000000