00000000000000000000
00000000000000000000
00000000000000000000
00011111111111110000
00010000000000010000
00010001111000010000
00010011221000010000
00010015321000010000
00010011321100010000
00010011232100010000
00010014322100010000
00010014494100010000
00010011111100010000
00010000000000010000
00010000000000010000
00010000000000010000
00011111111111110000
00000000000000000000
00000000000000000000
00000000000000000000