00000000000001000000
00000000000001000000
00000000000001000000
00000000000001000000
00000000000001000000
00000001111101000000
00000001251111000000
00000001232210000000
00000011121211000000
11111114121221111111
00000014322121000000
00000014222321000000
00000011111111000000
00000010000000000000
00000010000000000000
00000010000000000000
00000010000000000000
00000010000000000000
00000010000000000000
00000010000000000000