00000000000000000000
00000000000000000000
00000000000000000000
00000000000000000000
00000000000000000000
00000001111111111000
00001111222221111000
00001222411121111000
00001212122221111000
00001212323142111000
00001212292212111000
00001241323212111000
00001122221212111000
00000121114222251000
00000122222112221000
00000111111111111000
00000000001110000000
00000000110001100000
00000000010010000000
00000000011110000000